
# Diacritice (ăâîșț ĂÂÎȘȚ)

filter=Filtre
options=Opțiuni
physicsarena=fizicarena
language=Limbă
problem=Enunț
solution=Soluție
problems=Enunțuri
solutions=Soluții
website=Site
submit=Salvează
hide=Înapoi
welcome=Bine ați venit pe site-ul fizicarena!
desc=Acest site este o bază de date cu probleme de la multe olimpiade și concursuri școlare de fizică.
selectOly=Alege olimpiada/concursul:
homepage=Acasă - fizicarena
organized-by=Această olimpiadă este organizată de %.

title=Probleme % - fizicarena
oth-title=Alte probleme
group=Grupa %

i-title=Lista de probleme de la %, proba %
i-website=Website-ul oficial al olimpiadei
i-resources=Alte resurse:

e-th=Teoretică
e-ex=Practică

t-mech=Mecanică
t-grav=Gravitație
t-fluid=Fluide
t-thermo=Termo.
t-elec=Electro.
t-mag=Magnetism
t-osc=Oscilații
t-waves=Unde
t-quantum=Cuantică
t-rel=Relativitate
t-nuc=Atomi
t-math=Matematică
t-circ=Circuite
t-other=Altele
t-opt=Optică
t-cin=Cinematică

c-isr=Israel
c-prt=Portugalia
c-idn=Indonezia
c-che=Elveția
c-ind=India
c-kaz=Kazakhstan
c-dnk=Danemarca
c-est=Estonia
c-tha=Tailanda
c-hrv=Croația
c-mex=Mexic
c-vnm=Viet Nam
c-irn=Iran
c-sgp=Singapore
c-esp=Spania
c-kor=Korea de Sud
c-twn=Taiwan
c-tur=Turcia
c-gbr=Regatul Unit
c-ita=Italia
c-isl=Islanda
c-can=Canada
c-nor=Norvegia
c-aus=Australia
c-chn=China
c-usa=Statele Unite
c-fin=Finlanda
c-cub=Cuba
c-nld=Țările de Jos
c-pol=Polonia
c-aut=Austria
c-ede=Germania de Est
c-ygs=Yugoslavia
c-swe=Suedia
c-rou=Romania
c-wde=Germania de Vest
c-bgr=Bulgaria
c-ssr=Uniunea Sovietica
c-csk=Cehoslovacia
c-hun=Ungaria
c-rus=Rusia
c-hkg=Hong Kong
c-mng=Mongolia
c-www=Online
c-lva=Letonia

options-flags=Ascude steaguri
options-cname=Ascude țara organizatoare
options-website=Ascude site-ul olimpiadei
options-topics=Ascude domeniile problemelor
options-desc=Ascude descrierile de probleme
options-name=Ascude numele problemelor
options-dark=Activează tema întunecată

jan=Ianuarie
feb=Februarie
mar=Martie
apr=Aprilie
may=Mai
jun=Iunie
jul=Iulie
aug=August
sep=Septembrie
oct=Octombire
nov=Noiembrie
dec=Decembrie